Byleth	Commoner
Edelgard	Noble
Hubert	Noble
Ferdinand	Noble
Linhardt	Noble
Caspar	Noble
Bernadetta	Noble
Dorothea	Commoner
Petra	Commoner
Dimitri	Noble
Dedue	Commoner
Felix	Noble
Ashe	Commoner
Sylvain	Noble
Mercedes	Commoner
Annette	Noble
Ingrid	Noble
Claude	Noble
Lorenz	Noble
Raphael	Commoner
Ignatz	Commoner
Lysithea	Noble
Marianne	Noble
Hilda	Noble
Leonie	Commoner
Seteth	Wyvern Rider
Flayn	Priest
Hanneman	Mage
Manuela	Priest
Gilbert	Fortress Knight
Alois	Warrior
Catherine	Swordmaster
Shamir	Sniper
Cyril	Commoner
Jeritza	Death Knight
Anna	Myrmidon
Yuri	Commoner
Balthus	Noble
Constance	Noble
Hapi	Commoner